TTTTTTTTTTTTTTTTTTTTTTTTTTTTTTTTTTTTTTTTTTTTTTTTTTTTTTTTTTTTTTTTTTTTTTTTTTTTTTTTTTTTTT
T....................................................................................T
T....................................................................................T
T....................................................................................T
T....................................................................................T
T....................................................................................T
T.................................TTTTTTTTTTTTTTTTTTTTTTTTTTT........................T
T.................................TTTTTTTTTTTTTTTTTTTTTTTTTTT........................T
T.....................................................TTTTTTT........................T
T.........................RRRRRRRRRRRR................TTTTTTTTTTTTTTTTTTTTTTTTTTT....T
T.........................RRRRRRRRRRRR...............................................T
T.............dd.M.m......RRo.....oRRR......................344444444445.............T
T.............ddRRR.......RR...w...RRR.......ff.V.dd........2RRRRRRRRRR2.............T
T...............RRR....T..RR....T..RRR.......af...df....TT..2RRRWRRRRRR2.............T
T..............lRRRl......RRo.....oRRR...s.o......bf........2RRRRRRRRRR2.............T
T..............kRRRRRRRRRRRRRRRRRRRR@RRRRRRRRRRRRRRRR.......2RRRRRRRRRR2.............T
T..............kRRRRRRRRRRRRRRRRRRRRRRRRRRRRRRRRRRRRR.....l.14RRRRR44446.............T
T..............k.........oRR..............kRRk.....RRRRRRRRRRRRRRRRT.................T
T..............k..........RR.........ryr...RR......RRRRRRRRRRRRRRRRT.................T
T..............k..........RR....x.N..try...RR...............o...o....................T
T..............k...TT.....RR....r......t...RR....l...............TTT.................T
T..............k..........RRl..........t...RR...........TTT..........................T
T..............k..........RRRRRRRRRRRRRRRRRRR..TT....................................T
T.........................RRRRRRRRRRRRRRRRRRR........................................T
T....................................................................................T
T.............................kk.....................................................T
T....................................................................................T
T.........................................o..........................................T
T....................................................................................T
T....................................................................................T
T....................................................................................T
T....................................................................................T
.....................................................................................T
TTTTTTTTTTTTTTTTTTTTTTTTTTTTTTTTTTTTTTTTTTTTTTTTTTTTTTTTTTTTTTTTTTTTTTTTTTTTTTTTTTTTTT