OOOOOOOOOOOOOOOOO
O@...P...P..D...O
O..PP.P.P.P...P.O
O..PP.P.P..PPP..O
O..PP.PP.X...PD.O
O.....P...D..P..O
O.D...P.D..P..D.O
O.....P....P..P.O
OOOOOOOOOOOOOOOOO